1111111111
1P000C00E1
1000000001
1000000001
1111111111