1111111111111
100100C0000C1
1C00011111001
1P1011000E001
1111111111111