1111111111111111111
10000000C0000001111
1001011111000001111
10001111101100000C1
1C1100CCCCC11100001
10010000C0000P01111
1001000000000E01111
10001111101100000C1
1111111111111111111